70,70
**********DU**********DU**********DU**********DU**********DU**********
**********DU**********DU**********DU**********DU**********DU**********
**********DU**********DU**********DU**********DU**********DU**********
**********DU**********DU**********DU**********DU**********DU**********
**********DU**********DU**********DU**********DU**********DU**********
**********DU**********DU**********DU**********DU**********DU**********
**********DU**********DU**********DU**********DU**********DU**********
**********DU**********DU**********DU**********DU**********DU**********
**********DU**********DU**********DU**********DU**********DU**********
**********DU**********DU**********DU**********DU**********DU**********
LLLLLLLLLLSSLLLLLLLLLLSSLLLLLLLLLLSSLLLLLLLLLLSSLLLLLLLLLLSSLLLLLLLLLL
RRRRRRRRRRSSRRRRRRRRRRSSRRRRRRRRRRSSRRRRRRRRRRSSRRRRRRRRRRSSRRRRRRRRRR
**********DU**********DU**********DU**********DU**********DU**********
**********DU**********DU**********DU**********DU**********DU**********
**********DU**********DU**********DU**********DU**********DU**********
**********DU**********DU**********DU**********DU**********DU**********
**********DU**********DU**********DU**********DU**********DU**********
**********DU**********DU**********DU**********DU**********DU**********
**********DU**********DU**********DU**********DU**********DU**********
**********DU**********DU**********DU**********DU**********DU**********
**********DU**********DU**********DU**********DU**********DU**********
**********DU**********DU**********DU**********DU**********DU**********
LLLLLLLLLLSSLLLLLLLLLLSSLLLLLLLLLLSSLLLLLLLLLLSSLLLLLLLLLLSSLLLLLLLLLL
RRRRRRRRRRSSRRRRRRRRRRSSRRRRRRRRRRSSRRRRRRRRRRSSRRRRRRRRRRSSRRRRRRRRRR
**********DU**********DU**********DU**********DU**********DU**********
**********DU**********DU**********DU**********DU**********DU**********
**********DU**********DU**********DU**********DU**********DU**********
**********DU**********DU**********DU**********DU**********DU**********
**********DU**********DU**********DU**********DU**********DU**********
**********DU**********DU**********DU**********DU**********DU**********
**********DU**********DU**********DU**********DU**********DU**********
**********DU**********DU**********DU**********DU**********DU**********
**********DU**********DU**********DU**********DU**********DU**********
**********DU**********DU**********DU**********DU**********DU**********
LLLLLLLLLLSSLLLLLLLLLLSSLLLLLLLLLLSSLLLLLLLLLLSSLLLLLLLLLLSSLLLLLLLLLL
RRRRRRRRRRSSRRRRRRRRRRSSRRRRRRRRRRSSRRRRRRRRRRSSRRRRRRRRRRSSRRRRRRRRRR
**********DU**********DU**********DU**********DU**********DU**********
**********DU**********DU**********DU**********DU**********DU**********
**********DU**********DU**********DU**********DU**********DU**********
**********DU**********DU**********DU**********DU**********DU**********
**********DU**********DU**********DU**********DU**********DU**********
**********DU**********DU**********DU**********DU**********DU**********
**********DU**********DU**********DU**********DU**********DU**********
**********DU**********DU**********DU**********DU**********DU**********
**********DU**********DU**********DU**********DU**********DU**********
**********DU**********DU**********DU**********DU**********DU**********
LLLLLLLLLLSSLLLLLLLLLLSSLLLLLLLLLLSSLLLLLLLLLLSSLLLLLLLLLLSSLLLLLLLLLL
RRRRRRRRRRSSRRRRRRRRRRSSRRRRRRRRRRSSRRRRRRRRRRSSRRRRRRRRRRSSRRRRRRRRRR
**********DU**********DU**********DU**********DU**********DU**********
**********DU**********DU**********DU**********DU**********DU**********
**********DU**********DU**********DU**********DU**********DU**********
**********DU**********DU**********DU**********DU**********DU**********
**********DU**********DU**********DU**********DU**********DU**********
**********DU**********DU**********DU**********DU**********DU**********
**********DU**********DU**********DU**********DU**********DU**********
**********DU**********DU**********DU**********DU**********DU**********
**********DU**********DU**********DU**********DU**********DU**********
**********DU**********DU**********DU**********DU**********DU**********
LLLLLLLLLLSSLLLLLLLLLLSSLLLLLLLLLLSSLLLLLLLLLLSSLLLLLLLLLLSSLLLLLLLLLL
RRRRRRRRRRSSRRRRRRRRRRSSRRRRRRRRRRSSRRRRRRRRRRSSRRRRRRRRRRSSRRRRRRRRRR
**********DU**********DU**********DU**********DU**********DU**********
**********DU**********DU**********DU**********DU**********DU**********
**********DU**********DU**********DU**********DU**********DU**********
**********DU**********DU**********DU**********DU**********DU**********
**********DU**********DU**********DU**********DU**********DU**********
**********DU**********DU**********DU**********DU**********DU**********
**********DU**********DU**********DU**********DU**********DU**********
**********DU**********DU**********DU**********DU**********DU**********
**********DU**********DU**********DU**********DU**********DU**********
**********DU**********DU**********DU**********DU**********DU**********