30,30
**DU****DU****DU****DU****DU**
**DU****DU****DU****DU****DU**
LLSSLLLLSSLLLLSSLLLLSSLLLLSSLL
RRSSRRRRSSRRRRSSRRRRSSRRRRSSRR
**DU****DU****DU****DU****DU**
**DU****DU****DU****DU****DU**
**DU****DU****DU****DU****DU**
**DU****DU****DU****DU****DU**
LLSSLLLLSSLLLLSSLLLLSSLLLLSSLL
RRSSRRRRSSRRRRSSRRRRSSRRRRSSRR
**DU****DU****DU****DU****DU**
**DU****DU****DU****DU****DU**
**DU****DU****DU****DU****DU**
**DU****DU****DU****DU****DU**
LLSSLLLLSSLLLLSSLLLLSSLLLLSSLL
RRSSRRRRSSRRRRSSRRRRSSRRRRSSRR
**DU****DU****DU****DU****DU**
**DU****DU****DU****DU****DU**
**DU****DU****DU****DU****DU**
**DU****DU****DU****DU****DU**
LLSSLLLLSSLLLLSSLLLLSSLLLLSSLL
RRSSRRRRSSRRRRSSRRRRSSRRRRSSRR
**DU****DU****DU****DU****DU**
**DU****DU****DU****DU****DU**
**DU****DU****DU****DU****DU**
**DU****DU****DU****DU****DU**
LLSSLLLLSSLLLLSSLLLLSSLLLLSSLL
RRSSRRRRSSRRRRSSRRRRSSRRRRSSRR
**DU****DU****DU****DU****DU**
**DU****DU****DU****DU****DU**